###############
#.............#
#...C.........#
#..C..........#
#.............#
#.....RDL.....#
#.....T.T.....#
#.....rDl.....#
#......@......#
#.............#
#.............#
#.......B.....#
#.............#
#.............#
#.............#
###############