###############
#.............#
#...C......N..#
#..C..........#
#......e......#
#.....RDL.....#
#.....T.T.....#
#.....rDl.....#
#......@......#
#.............#
#.............#
#.......B.....#
#..S..........#
#..........P..#
#.............#
###############