#################
#...............#
#...CS..........#
#..C............#
#......e........#
#.....RDL.......#
#.....T.T.......#
#.....rDl.......#
#......@........#
#...............#
#...............#
#.......BN......#
#...............#
#..P............#
#...............#
#################